5,5,5,5,5,5,5,5,6,6,11,6,6,5,5,5,5,5,5,5,5,5,5,5,5,5,5,5,5,5,5,5
5,6,6,6,6,6,6,6,6,3,3,3,6,6,6,5,5,6,6,6,6,6,6,6,6,6,6,6,6,6,6,5
5,6,15,15,3,3,3,3,3,3,3,3,3,15,6,5,5,6,23,4,4,4,4,4,15,15,6,18,4,4,6,5
5,6,19,3,3,3,3,3,3,3,3,3,3,15,6,5,5,6,15,4,4,4,4,4,4,4,6,4,4,4,6,5
5,6,3,3,3,3,3,3,3,3,3,3,3,18,6,5,5,6,4,4,4,4,4,4,4,4,4,4,4,4,6,5
5,6,3,3,3,3,3,3,3,3,3,3,7,7,6,5,5,6,4,4,4,4,4,4,4,4,4,4,4,4,6,5
5,6,3,3,3,3,6,6,3,3,3,3,3,3,6,5,5,6,6,6,6,6,4,4,4,4,4,4,4,19,6,5
5,6,3,3,3,3,18,6,3,3,3,3,3,3,6,5,5,5,5,5,5,6,6,6,6,4,4,4,4,15,6,5
5,6,3,3,3,3,15,6,3,3,3,3,3,3,6,5,5,5,5,5,5,6,15,18,6,4,4,4,4,15,6,5
5,6,3,3,3,3,22,6,19,3,3,3,3,3,6,6,6,6,6,5,5,6,4,4,4,4,4,4,4,15,6,5
5,6,18,3,3,3,6,6,6,6,3,3,3,3,3,3,3,3,6,6,6,6,4,4,4,4,4,4,4,18,6,5
5,6,15,3,3,3,6,5,5,6,18,15,3,3,3,3,3,3,3,6,12,4,4,4,4,4,4,4,4,4,6,5
5,6,15,3,3,3,6,5,5,6,7,7,3,3,3,3,3,3,3,10,4,4,4,4,4,15,15,4,4,4,6,5
5,6,7,7,3,3,6,6,6,6,15,3,3,3,3,3,3,3,3,6,4,4,4,4,19,15,6,15,4,4,6,5
5,6,19,3,3,3,3,3,3,3,3,3,3,3,3,3,3,3,6,6,6,6,6,6,6,6,6,6,6,6,6,5
5,6,3,3,3,3,3,3,3,3,3,3,3,3,3,3,3,3,6,5,5,5,5,5,5,5,5,5,5,5,5,5
5,6,3,3,3,3,3,3,3,3,3,3,3,15,7,3,3,3,6,5,5,5,5,5,5,5,5,5,5,5,5,5
5,6,3,3,3,3,3,3,3,3,3,3,15,15,7,18,15,19,6,5,5,6,6,6,6,6,6,6,6,6,6,5
5,6,6,3,3,3,6,6,6,6,6,6,6,6,6,6,6,6,6,5,5,6,14,1,1,1,1,1,15,15,6,5
5,5,6,12,3,3,6,5,5,5,5,5,5,5,5,5,5,5,5,5,5,6,1,1,1,0,1,1,1,1,6,5
5,5,6,6,9,6,6,5,5,5,5,5,5,5,5,5,5,5,5,5,5,6,1,1,1,1,1,1,1,1,6,5
5,6,6,2,2,2,6,6,6,6,6,6,6,6,6,6,6,6,6,5,5,6,1,0,1,1,1,6,20,1,6,5
5,6,15,2,2,2,19,6,15,2,2,2,2,2,15,7,18,15,6,5,5,6,1,1,1,1,1,6,15,1,6,5
5,6,15,2,2,2,2,6,15,2,2,2,2,2,2,7,2,2,6,5,5,6,15,17,12,1,1,6,19,1,6,5
5,6,2,2,2,2,2,6,18,2,2,2,2,2,2,2,2,2,6,5,5,6,6,6,6,1,1,6,1,1,6,5
5,6,2,2,2,2,6,6,6,6,2,2,2,2,2,2,2,2,6,6,6,6,18,15,6,1,1,1,1,1,6,5
5,6,2,2,2,2,2,2,2,2,2,2,2,6,2,2,2,2,2,2,6,1,1,1,1,1,1,1,0,1,6,5
5,6,2,2,2,2,2,2,2,2,2,2,2,6,2,2,2,2,2,2,8,1,1,1,1,1,1,1,1,1,6,5
5,6,15,2,2,2,7,2,2,2,2,2,2,6,15,2,2,2,2,12,6,1,1,1,1,1,0,1,1,1,6,5
5,6,18,2,2,19,7,15,21,2,2,18,15,6,19,2,2,15,6,6,6,6,15,14,1,1,1,1,1,16,6,5
5,6,6,6,6,6,6,6,6,6,6,6,6,6,6,6,6,6,6,5,5,6,6,6,6,6,6,6,6,6,6,5
5,5,5,5,5,5,5,5,5,5,5,5,5,5,5,5,5,5,5,5,5,5,5,5,5,5,5,5,5,5,5,5
